0 0 0 0 0 0 0 0 0 0 0 0 0 0 0 0
0 7 1 1 1 1 2 1 1 1 1 1 1 1 2 0
0 0 0 0 0 0 1 0 0 0 0 0 0 0 1 0
0 0 0 0 0 0 1 0 0 0 0 0 0 0 1 0
0 0 0 0 0 0 1 0 0 0 0 0 0 0 1 0
0 0 2 1 1 1 2 1 1 1 1 1 1 1 2 0
0 0 1 0 0 0 1 0 0 0 0 0 0 0 1 0
0 0 1 0 0 0 1 0 0 0 0 0 0 0 1 0
0 0 1 0 0 0 1 0 0 0 0 0 0 0 1 0
0 0 1 0 0 0 1 0 0 0 0 6 0 0 1 0
0 0 2 1 1 1 2 1 1 1 1 1 1 1 3 0
0 0 0 0 0 0 0 0 0 0 0 0 0 0 0 0